10
-.-.-.P.-.-.-.-.-.-.-
-.-.-.-.-.-.-.-.H_P.-.-
-.G.-.-.-.-.-.-.-.-.-.-
-.P_G.-.-.-.W.-.-.-.-.-
-.-.-.-.-.-.P.-.-.G.-.-
-.H_P.-.-.-.-.-.-.-.-.-
-.W.-.-.-.-.-.-.-.-.-.-
-.P.-.-.-.-.-.-.-.-.-.-
-.-.-.-.-.-.-.P_G.-.-.-
-.G.-.-.-.P.-.-.-.-.-.-