10
-.-.-.-.-.-.-.-.-.-
-.P.-.-.-.W.-.-.-.-
-.-.-.G.-.-.-.P.-.-
-.H_P.-.-.-.-.P_G.-.-.-.-
-.-.-.-.-.-.-.-.-.-
-.P.-.-.-.-.-.-.-.-
-.-.W.-.-.G.-.-.P.-.-
-.P_G.-.-.-.-.H_P.-.-
-.-.-.-.-.-.-.-.-.-
-.-.-.-.-.G.-.-.P.-
