10
-.-.-.-.-.-.-.-.P.-.-
-.P_G.-.-.-.-.-.-.-.-.-
-.H_P.-.-.-.G.-.-.-.-.-
-.-.-.-.-.W.-.-.-.-.P.-
-.P.-.-.-.-.-.-.-.-.G.-
-.-.-.-.-.-.-.P_G.-.-.-
-.W.-.-.-.-.H_P.-.-.-.-
-.-.G.-.-.P.-.-.-.-.-.-
-.-.-.-.-.-.-.W.-.-.-.-
-.P.-.-.-.-.-.-.-.-.-
